@room 52
@title Back Stairway
@conn 54 25 49 53
@spawn 44 104
@border RED
@belt 0

@guardiansprites
; entity 36: page 175 sprite 4 f=0..3
12,0,22,0,47,0,47,0,79,128,95,128,95,128,159,192,191,192,189,192,186,192,189,64,90,128,93,128,63,0,12,0
0,0,0,0,0,0,0,112,3,152,12,120,51,248,71,240,95,240,191,240,190,160,189,96,90,192,93,64,63,128,14,0
0,0,0,0,0,0,0,0,3,192,28,120,33,252,79,254,95,254,159,255,191,239,95,86,95,174,35,84,31,248,3,192
0,0,0,0,0,0,14,0,23,192,23,240,19,252,11,254,11,254,11,215,5,235,5,215,2,234,2,126,1,140,0,112
; entity 92: page 183 sprite 4 f=4..7
118,0,0,0,110,0,118,0,110,0,0,0,118,0,110,0,0,0,118,0,0,0,0,0,110,0,118,0,0,0,110,0
29,128,42,0,39,96,81,176,75,208,144,128,170,232,148,184,145,128,170,216,145,0,85,0,75,176,43,96,36,0,29,128
3,192,12,48,16,152,50,20,104,130,64,42,181,17,200,69,164,145,154,5,72,66,85,10,40,84,18,136,13,112,3,192
1,184,0,84,6,228,13,138,11,210,1,9,23,85,29,41,1,137,27,85,0,137,0,170,13,210,6,212,0,36,1,184
; entity 29: page 178 sprite 4 f=8..11
3,192,14,240,29,248,62,252,83,206,101,166,164,39,113,143,191,247,85,239,110,118,83,202,56,28,22,120,11,240,2,192
3,192,13,240,26,248,63,252,81,140,100,38,197,167,179,207,93,187,170,119,95,250,114,78,56,28,28,56,11,240,2,192
3,192,11,240,21,120,63,252,80,12,101,166,199,231,241,143,190,127,221,247,44,58,90,94,44,60,22,120,11,240,3,192
3,192,13,240,26,248,63,252,81,140,100,38,197,167,179,207,93,187,170,119,95,250,114,78,56,28,28,56,11,240,2,192

@tilemap
                /WWWWWWW
               /WWWWWWWW
              /FFFFFFFFF
             /          
            /           
           /FFFFFFFFFFFF
          /             
         /              
        /FFFFFFFFFFFFFFF
       /                
      /                 
FFFFF/ FFFFFFFFFFFFFFFFF
    /                   
   /                    
  /                     
F/FFFFFFFFFF+FFFFFFFFFFF

@floorcolor PUR
@wallcolor YEL
@nastycolor WHT
@rampcolor WHT
@beltcolor WHT
@itemcolor BLK

@guardians
y=104 x=17(9..22) v=1 f=0..3 CYN
y=48 x=15(11..17) v=-1 f=4..7 WHT
x=2 y=24(0..64) v=2 f=8..11 CYN

@floorudg 255,68,68,255,17,17,255,0 ; invert
@walludg 21,241,143,168,138,248,31,21
@nastyudg 0,0,0,0,0,0,0,0 ; invert
@rampudg 3,1,12,4,48,16,192,64 ; invert
@beltudg 0,0,0,0,0,0,0,0 ; invert
