@room 8
@title Inside MegaTrunk
@conn 12 7 3 9
@spawn 44 104
@border GRN
@belt 0

@guardiansprites
; entity 9: page 191 sprite 0 f=0..1
128,0,64,0,163,96,83,96,41,192,22,160,11,224,7,112,2,168,5,212,2,42,3,229,3,226,3,97,3,98,7,112
0,0,0,0,6,48,86,48,169,192,86,160,11,224,6,48,3,232,5,212,2,42,3,228,3,234,23,100,14,96,4,112
; entity 24: page 188 sprite 0 f=2..9
0,0,0,0,0,0,0,0,0,0,111,64,187,128,117,64,26,128,5,0,0,128,0,0,0,0,0,0,0,0,0,0
0,0,0,0,0,160,1,64,2,128,1,80,54,160,93,112,55,224,3,192,0,0,0,0,0,0,0,0,0,0,0,0
0,0,0,0,0,0,0,0,0,0,0,244,25,184,47,84,25,168,0,80,0,8,0,0,0,0,0,0,0,0,0,0
0,0,0,0,0,0,0,0,0,0,0,61,3,126,5,215,3,106,0,20,0,40,0,20,0,10,0,0,0,0,0,0
0,0,0,0,0,0,0,0,0,0,188,0,126,192,235,160,86,192,40,0,20,0,40,0,80,0,0,0,0,0,0,0
0,0,0,0,0,0,0,0,0,0,47,0,29,152,42,244,21,152,10,0,16,0,0,0,0,0,0,0,0,0,0,0
0,0,0,0,5,0,2,128,1,64,10,128,5,108,14,186,7,236,3,192,0,0,0,0,0,0,0,0,0,0,0,0
0,0,0,0,0,0,0,0,0,0,2,246,1,221,2,174,1,88,0,160,1,0,0,0,0,0,0,0,0,0,0,0
; entity 44: page 186 sprite 1 f=10..10
7,224,15,240,31,248,255,255,31,248,31,248,49,140,42,84,113,142,158,249,141,241,29,184,50,76,88,26,76,50,7,224
; entity 47: page 187 sprite 4 f=11..14
4,0,42,128,85,64,43,128,68,64,175,160,95,64,32,128,85,64,42,128,4,0,4,0,8,0,62,0,65,0,129,0
2,0,21,64,42,160,21,192,34,32,95,80,42,160,16,64,42,160,21,64,2,0,2,0,14,0,17,128,32,64,0,0
0,64,2,168,5,84,3,168,4,68,11,234,5,244,2,8,5,84,2,168,0,64,0,64,0,112,1,136,2,4,0,0
0,32,1,84,2,170,1,212,2,34,5,125,2,250,1,84,2,170,1,84,0,32,0,32,0,16,0,124,0,130,0,129

@tilemap
          W W           
          W W           
          W W           
          W             
          W             
            WWWWWWW     
            W           
WWWWWWWWWWW W      \    
 *  *  *  W W       \   
 *  *  *  W W        \  
 *  *  *  W W           
 *  *  *  W             
 *  *  *  W             
 *  *  *  W WWWWWWWWWWWW
 *  *  *  W W           
 *  *  *  W +           

@floorcolor GRN
@wallcolor YEL
@nastycolor YEL
@rampcolor WHT
@beltcolor WHT
@itemcolor BLK

@guardians
x=2 y=80(64..112) v=2 f=0..1 PUR
x=5 y=80(64..112) v=2 f=0..1 PUR
x=8 y=80(64..112) v=2 f=0..1 PUR
y=40 x=6(0..10) v=-1 f=2..9 CYN
x=11 y=32(0..104) v=2 f=10..10 RED
y=88 x=19(12..21) v=-1 f=2..9 GRN

@floorudg 245,250,191,31,38,20,34,16
@walludg 171,171,173,170,170,174,85,85
@nastyudg 110,116,56,30,110,116,56,30
@rampudg 64,0,16,0,4,0,1,0
@beltudg 0,0,0,0,0,0,0,0 ; invert
