@room 48
@title Nomen Luni
@conn 0 18 42 0
@spawn 44 104
@border RED
@belt 0

@guardiansprites
; entity 104: page 188 sprite 0 f=0..7
0,0,0,0,0,0,0,0,0,0,111,64,187,128,117,64,26,128,5,0,0,128,0,0,0,0,0,0,0,0,0,0
0,0,0,0,0,160,1,64,2,128,1,80,54,160,93,112,55,224,3,192,0,0,0,0,0,0,0,0,0,0,0,0
0,0,0,0,0,0,0,0,0,0,0,244,25,184,47,84,25,168,0,80,0,8,0,0,0,0,0,0,0,0,0,0
0,0,0,0,0,0,0,0,0,0,0,61,3,126,5,215,3,106,0,20,0,40,0,20,0,10,0,0,0,0,0,0
0,0,0,0,0,0,0,0,0,0,188,0,126,192,235,160,86,192,40,0,20,0,40,0,80,0,0,0,0,0,0,0
0,0,0,0,0,0,0,0,0,0,47,0,29,152,42,244,21,152,10,0,16,0,0,0,0,0,0,0,0,0,0,0
0,0,0,0,5,0,2,128,1,64,10,128,5,108,14,186,7,236,3,192,0,0,0,0,0,0,0,0,0,0,0,0
0,0,0,0,0,0,0,0,0,0,2,246,1,221,2,174,1,88,0,160,1,0,0,0,0,0,0,0,0,0,0,0
; entity 107: page 190 sprite 0 f=8..11
12,0,18,0,33,0,45,0,33,0,18,0,12,0,12,0,30,0,0,0,55,0,64,0,13,64,172,64,64,128,46,0
14,192,29,160,31,0,31,224,31,0,29,160,14,192,3,0,7,128,0,0,14,192,0,32,43,0,35,80,16,96,7,0
4,8,6,24,7,56,15,252,7,56,6,216,4,200,0,192,1,224,0,0,1,208,4,8,8,212,10,192,0,8,3,176
0,220,1,110,0,62,1,254,0,62,1,110,0,220,0,48,0,120,0,0,0,184,1,2,2,177,0,53,1,0,0,220
; entity 29: page 178 sprite 4 f=12..15
3,192,14,240,29,248,62,252,83,206,101,166,164,39,113,143,191,247,85,239,110,118,83,202,56,28,22,120,11,240,2,192
3,192,13,240,26,248,63,252,81,140,100,38,197,167,179,207,93,187,170,119,95,250,114,78,56,28,28,56,11,240,2,192
3,192,11,240,21,120,63,252,80,12,101,166,199,231,241,143,190,127,221,247,44,58,90,94,44,60,22,120,11,240,3,192
3,192,13,240,26,248,63,252,81,140,100,38,197,167,179,207,93,187,170,119,95,250,114,78,56,28,28,56,11,240,2,192
; entity 11: page 191 sprite 0 f=16..19
128,0,64,0,163,96,83,96,41,192,22,160,11,224,7,112,2,168,5,212,2,42,3,229,3,226,3,97,3,98,7,112
0,0,0,0,6,48,86,48,169,192,86,160,11,224,6,48,3,232,5,212,2,42,3,228,3,234,23,100,14,96,4,112
0,0,0,0,3,96,3,96,1,192,30,160,43,224,86,180,163,106,69,213,130,34,3,225,3,226,3,96,3,96,7,112
0,0,0,0,6,48,86,48,169,192,86,160,11,224,7,244,2,42,5,213,2,34,3,225,3,224,3,116,3,56,7,16

@tilemap
                        
                        
                        
                        
                        
             WWWWWW     
           F WWWWWW FF  
               WW       
       FFF     WW       
             F WW     WW
               WW    WWW
         /  F  WW  WWW W
        /     FWW  FF  W
       /       WW     WW
      / WWWWWWWWWWWWWW W
     /  WWWW+WWWWWWWWW W

@tilecolors WHT CYN PUR YEL WHT WHT
@itemcolor RED

@guardians
y=16 x=1(0..6) v=-1 f=0..7 YEL
y=24 x=15(13..17) v=1 f=8..11 GRN
x=12 y=24(0..64) v=2 f=12..15 CYN
x=17 y=96(56..96) v=-5 f=16..19 YEL

@tileudg
0: 0,0,0,0,0,0,0,0
1: 255,34,68,136,85,34,0,0
2: 170,112,170,108,177,95,170,85 ; invert
3: 85,162,85,152,28,42,69,138
4: 3,0,12,0,52,10,196,0
5: 0,0,0,0,0,0,0,0 ; invert
6: 18,18,18,18,18,18,18,18
