@room 45
@title Under the Drive
@conn 4 46 0 6
@spawn 44 104
@border GRN
@belt -1

@guardiansprites
; entity 28: page 188 sprite 0 f=0..7
0,0,0,0,0,0,0,0,0,0,111,64,187,128,117,64,26,128,5,0,0,128,0,0,0,0,0,0,0,0,0,0
0,0,0,0,0,160,1,64,2,128,1,80,54,160,93,112,55,224,3,192,0,0,0,0,0,0,0,0,0,0,0,0
0,0,0,0,0,0,0,0,0,0,0,244,25,184,47,84,25,168,0,80,0,8,0,0,0,0,0,0,0,0,0,0
0,0,0,0,0,0,0,0,0,0,0,61,3,126,5,215,3,106,0,20,0,40,0,20,0,10,0,0,0,0,0,0
0,0,0,0,0,0,0,0,0,0,188,0,126,192,235,160,86,192,40,0,20,0,40,0,80,0,0,0,0,0,0,0
0,0,0,0,0,0,0,0,0,0,47,0,29,152,42,244,21,152,10,0,16,0,0,0,0,0,0,0,0,0,0,0
0,0,0,0,5,0,2,128,1,64,10,128,5,108,14,186,7,236,3,192,0,0,0,0,0,0,0,0,0,0,0,0
0,0,0,0,0,0,0,0,0,0,2,246,1,221,2,174,1,88,0,160,1,0,0,0,0,0,0,0,0,0,0,0
; entity 29: page 178 sprite 4 f=8..11
3,192,14,240,29,248,62,252,83,206,101,166,164,39,113,143,191,247,85,239,110,118,83,202,56,28,22,120,11,240,2,192
3,192,13,240,26,248,63,252,81,140,100,38,197,167,179,207,93,187,170,119,95,250,114,78,56,28,28,56,11,240,2,192
3,192,11,240,21,120,63,252,80,12,101,166,199,231,241,143,190,127,221,247,44,58,90,94,44,60,22,120,11,240,3,192
3,192,13,240,26,248,63,252,81,140,100,38,197,167,179,207,93,187,170,119,95,250,114,78,56,28,28,56,11,240,2,192
; entity 68: page 174 sprite 4 f=12..19
12,0,18,0,33,16,18,32,140,64,82,128,47,0,47,0,95,128,95,128,95,128,0,0,255,192,93,128,93,128,255,192
0,1,0,2,131,4,76,200,35,16,20,160,11,192,11,192,23,224,23,224,23,224,0,0,63,240,27,176,27,176,63,240
128,0,64,0,32,1,17,226,8,196,5,40,2,240,2,240,5,248,5,248,5,248,0,0,15,252,11,116,11,116,15,252
0,0,0,0,8,48,4,204,2,49,1,74,0,188,0,188,1,126,1,126,1,126,0,0,3,255,2,237,2,237,3,255
56,0,124,0,126,0,109,128,68,64,108,64,124,32,124,0,124,12,124,50,252,204,255,48,252,192,127,0,108,0,56,0
14,96,31,148,31,8,27,32,17,80,27,80,31,160,31,160,127,64,223,64,223,128,159,128,127,0,31,0,27,0,14,0
3,128,7,192,7,224,6,216,4,68,14,196,127,194,239,192,239,192,143,192,119,192,7,192,7,192,7,192,6,192,3,128
0,224,1,240,1,240,1,178,1,21,1,181,1,250,1,250,7,244,13,244,13,248,9,248,7,240,1,240,1,176,0,224

@tilemap
WW              WWWWWWWW
WW              WWWWWWWW
WW              WWWWWWWW
WW            FFWWWWWWWW
WWW             WWWWWWWW
WWWW     F         WWWWW
WWWWW       FF      WWWW
WWWWW                 WW
WWWWW   FF              
WWWWW       *           
WWWWW     <<<<<<<<<<<<<<
WWWWW                   
WWWWW                   
WWWWW                   
WWWWW\   *    *   *     
WWWWWW\WWWWW+WWWWWWWWWWW

@tilecolors WHT YEL GRN GRN WHT RED
@itemcolor BLU

@guardians
y=88 x=8(5..21) v=-1 f=0..7 YEL
x=10 y=24(0..64) v=2 f=8..11 CYN
y=64 x=14(13..22) v=-1 f=12..19 PUR

@tileudg
0: 0,0,0,0,0,0,0,0
1: 255,255,165,88,36,66,32,0
2: 16,42,85,160,16,32,16,8
3: 24,24,20,34,34,85,17,40
4: 128,64,160,80,168,84,170,85
5: 224,170,248,0,255,255,102,102
6: 129,100,205,15,97,218,51,26
