@room 36
@title A bit of tree
@conn 42 35 30 37
@spawn 44 104
@border CYN
@belt 0

@guardiansprites
; entity 104: page 188 sprite 0 f=0..7
0,0,0,0,0,0,0,0,0,0,111,64,187,128,117,64,26,128,5,0,0,128,0,0,0,0,0,0,0,0,0,0
0,0,0,0,0,160,1,64,2,128,1,80,54,160,93,112,55,224,3,192,0,0,0,0,0,0,0,0,0,0,0,0
0,0,0,0,0,0,0,0,0,0,0,244,25,184,47,84,25,168,0,80,0,8,0,0,0,0,0,0,0,0,0,0
0,0,0,0,0,0,0,0,0,0,0,61,3,126,5,215,3,106,0,20,0,40,0,20,0,10,0,0,0,0,0,0
0,0,0,0,0,0,0,0,0,0,188,0,126,192,235,160,86,192,40,0,20,0,40,0,80,0,0,0,0,0,0,0
0,0,0,0,0,0,0,0,0,0,47,0,29,152,42,244,21,152,10,0,16,0,0,0,0,0,0,0,0,0,0,0
0,0,0,0,5,0,2,128,1,64,10,128,5,108,14,186,7,236,3,192,0,0,0,0,0,0,0,0,0,0,0,0
0,0,0,0,0,0,0,0,0,0,2,246,1,221,2,174,1,88,0,160,1,0,0,0,0,0,0,0,0,0,0,0
; entity 101: page 171 sprite 0 f=8..11
0,0,0,0,42,170,127,255,127,255,124,63,124,63,127,255,127,255,127,255,0,0,42,170,0,0,42,170,0,0,0,0
0,72,1,44,4,188,18,254,75,254,46,127,188,63,254,124,255,242,127,201,127,37,60,148,50,80,9,64,5,0,4,0
0,0,7,224,15,240,23,232,15,240,22,104,14,112,22,104,15,240,23,232,15,240,23,232,8,16,23,232,16,8,0,0
18,0,52,128,61,32,127,72,127,210,254,116,252,61,62,127,79,255,147,254,164,254,41,60,10,76,2,144,0,160,0,32

@tilemap
        WW             *
        WW             *
        WW             *
        WW             *
     F  WW     F       *
        WW             *
  FF    WW       FF    *
     F  WW             *
        WW      /      *
     FF WW     /  F    *
FFF     WWFFF          *
        WW         F   *
        WW        F    *
        WW   FF        *
        WW             *
       FWWF +          *

@tilecolors WHT GRN YEL RED GRN WHT
@itemcolor BLK

@guardians
y=16 x=1(0..6) v=-1 f=0..7 YEL
x=4 y=48(40..80) v=2 f=8..11 PUR

@tileudg
0: 0,0,0,0,0,0,0,0
1: 173,82,41,0,1,2,0,0
2: 214,107,102,219,105,107,217,109
3: 21,0,170,85,170,0,21,10
4: 3,8,36,16,64,32,128,128 ; invert
5: 0,0,0,0,0,0,0,0 ; invert
6: 0,0,0,0,0,0,0,0
