@room 20
@title Ballroom East
@conn 26 11 0 21
@spawn 44 104
@border RED
@belt 0

@guardiansprites
; entity 19: page 156 sprite 3 f=0..0
0,0,0,0,0,0,0,0,0,0,0,0,0,0,0,0,0,0,0,0,0,0,0,0,0,0,0,0,0,0,0,0
; entity 42: page 186 sprite 0 f=1..1
7,224,15,240,223,251,63,252,31,248,31,248,49,140,106,86,177,141,158,249,13,240,29,184,54,108,89,154,140,49,7,224
; entity 41: page 186 sprite 1 f=2..5
7,224,15,240,31,248,255,255,31,248,31,248,49,140,42,84,113,142,158,249,141,241,29,184,50,76,88,26,76,50,7,224
7,224,15,240,31,248,223,251,63,252,31,248,49,140,42,84,48,140,93,250,141,177,154,89,18,72,24,24,44,52,199,227
7,224,143,241,95,250,63,252,31,248,17,136,46,116,42,84,113,142,94,250,141,241,29,184,18,72,120,30,140,49,7,224
21,3,42,190,21,94,74,168,53,92,138,174,109,92,153,249,110,191,221,99,46,73,89,129,4,130,43,198,18,252,12,253
; entity 21: page 188 sprite 0 f=6..13
0,0,0,0,0,0,0,0,0,0,111,64,187,128,117,64,26,128,5,0,0,128,0,0,0,0,0,0,0,0,0,0
0,0,0,0,0,160,1,64,2,128,1,80,54,160,93,112,55,224,3,192,0,0,0,0,0,0,0,0,0,0,0,0
0,0,0,0,0,0,0,0,0,0,0,244,25,184,47,84,25,168,0,80,0,8,0,0,0,0,0,0,0,0,0,0
0,0,0,0,0,0,0,0,0,0,0,61,3,126,5,215,3,106,0,20,0,40,0,20,0,10,0,0,0,0,0,0
0,0,0,0,0,0,0,0,0,0,188,0,126,192,235,160,86,192,40,0,20,0,40,0,80,0,0,0,0,0,0,0
0,0,0,0,0,0,0,0,0,0,47,0,29,152,42,244,21,152,10,0,16,0,0,0,0,0,0,0,0,0,0,0
0,0,0,0,5,0,2,128,1,64,10,128,5,108,14,186,7,236,3,192,0,0,0,0,0,0,0,0,0,0,0,0
0,0,0,0,0,0,0,0,0,0,2,246,1,221,2,174,1,88,0,160,1,0,0,0,0,0,0,0,0,0,0,0

@tilemap
WWF   WW                
WWF   WW                
WWF   WW                
  F                     
  F                     
FFFFFFWW  WWWWWWWWWWWWWW
     F                  
     F                  
     FFFFFFFFFFFFFFFFFFF
     F                  
     F                  
     F                  
     F                  
     F                  
WWWWWWWWWWWWWWWWWWWWWWWW
WWWWWWWWWWWW+WWWWWWWWWWW

@floorcolor YEL
@wallcolor WHT
@nastycolor WHT
@rampcolor WHT
@beltcolor WHT
@itemcolor BLU

@guardians
x=8 y=16(16..48) v=1 f=0..0 RED
x=3 y=72(48..87) v=-3 f=1..1 PUR
x=4 y=56(48..96) v=2 f=1..1 CYN
x=7 y=75(72..96) v=1 f=2..5 YEL
y=80 x=16(10..21) v=1 f=6..13 PUR

@floorudg 170,85,34,68,34,68,34,68
@walludg 68,68,255,17,17,255,85,170
@nastyudg 0,0,0,0,0,0,0,0 ; invert
@rampudg 0,0,0,0,0,0,0,0 ; invert
@beltudg 0,0,0,0,0,0,0,0 ; invert
@itemudg 129,129,66,36,24,24,24,231
