@room 54
@title West  Wing
@conn 56 31 52 55
@spawn 44 104
@border RED
@belt 0

@guardiansprites
; entity 97: page 172 sprite 0 f=0..3
32,4,174,236,187,125,224,7,189,181,160,4,59,124,0,0,29,176,32,4,59,124,162,68,253,183,160,4,59,220,32,4
32,4,55,180,160,4,251,127,160,4,61,180,32,4,27,120,0,0,61,180,162,68,187,125,224,7,189,181,183,236,32,4
32,4,58,220,61,189,224,7,59,117,32,4,61,188,0,0,27,112,32,4,61,189,162,69,251,119,160,5,61,237,32,4
32,4,59,117,160,5,253,191,160,5,59,117,32,4,29,184,0,0,59,116,36,132,61,189,224,7,59,117,46,236,32,4
; entity 89: page 176 sprite 6 f=4..5
1,128,0,0,1,128,69,145,1,128,137,162,69,145,1,128,205,179,205,179,205,179,205,179,35,196,18,72,13,176,0,0
1,128,0,0,1,128,137,162,1,128,69,145,137,162,1,128,205,179,205,179,205,179,205,179,35,196,18,72,13,176,0,0
; entity 20: page 188 sprite 0 f=6..13
0,0,0,0,0,0,0,0,0,0,111,64,187,128,117,64,26,128,5,0,0,128,0,0,0,0,0,0,0,0,0,0
0,0,0,0,0,160,1,64,2,128,1,80,54,160,93,112,55,224,3,192,0,0,0,0,0,0,0,0,0,0,0,0
0,0,0,0,0,0,0,0,0,0,0,244,25,184,47,84,25,168,0,80,0,8,0,0,0,0,0,0,0,0,0,0
0,0,0,0,0,0,0,0,0,0,0,61,3,126,5,215,3,106,0,20,0,40,0,20,0,10,0,0,0,0,0,0
0,0,0,0,0,0,0,0,0,0,188,0,126,192,235,160,86,192,40,0,20,0,40,0,80,0,0,0,0,0,0,0
0,0,0,0,0,0,0,0,0,0,47,0,29,152,42,244,21,152,10,0,16,0,0,0,0,0,0,0,0,0,0,0
0,0,0,0,5,0,2,128,1,64,10,128,5,108,14,186,7,236,3,192,0,0,0,0,0,0,0,0,0,0,0,0
0,0,0,0,0,0,0,0,0,0,2,246,1,221,2,174,1,88,0,160,1,0,0,0,0,0,0,0,0,0,0,0

@tilemap
    WW                 /
    WW                / 
    WW               /  
FFFFWW              /   
    WW             /    
    WW            /     
                 /      
                /       
               /        
              /         
             /          
            /           
FFFFFFF    /FFFFFFFFFFFF
          /WWWWWWWWWWWWW
         /WWWWWWWWWWWWWW
        /WWW+WWWWWWWWWWW

@tilecolors WHT BLU WHT WHT WHT WHT
@itemcolor BLK

@guardians
x=7 y=32(0..96) v=4 f=0..3 CYN
x=4 y=48(40..56) v=0 f=4..5 YEL
y=80 x=6(0..6) v=-1 f=6..13 RED

@tileudg
0: 0,0,0,0,0,0,0,0
1: 249,255,63,213,170,21,74,132 ; invert
2: 172,174,1,173,173,2,172,232
3: 0,0,0,0,0,0,0,0 ; invert
4: 3,3,12,12,48,48,192,192
5: 0,0,0,0,0,0,0,0 ; invert
6: 0,0,0,0,0,0,0,0
