@room 11
@title The Hall
@conn 0 10 0 20
@spawn 44 104
@border GRN
@belt 0

@guardiansprites
; entity 89: page 176 sprite 6 f=0..1
1,128,0,0,1,128,69,145,1,128,137,162,69,145,1,128,205,179,205,179,205,179,205,179,35,196,18,72,13,176,0,0
1,128,0,0,1,128,137,162,1,128,69,145,137,162,1,128,205,179,205,179,205,179,205,179,35,196,18,72,13,176,0,0
; entity 26: page 182 sprite 0 f=2..9
0,0,0,0,0,0,0,0,0,0,19,64,23,128,63,192,85,64,250,160,253,64,31,160,8,128,5,0,0,0,0,0
0,0,0,0,0,0,0,0,0,0,8,208,5,224,15,240,22,176,61,80,62,168,7,80,2,168,2,84,0,40,0,20
0,0,0,0,0,0,0,0,0,0,2,52,1,120,3,252,5,84,15,170,15,212,1,250,0,136,1,4,0,0,0,0
0,3,0,10,0,21,0,10,0,21,0,171,0,86,0,235,1,85,3,235,3,255,0,126,0,34,0,34,0,0,0,0
128,0,80,0,168,0,80,0,168,0,213,0,106,0,215,0,170,128,215,192,255,192,126,0,68,0,68,0,0,0,0,0
0,0,0,0,0,0,0,0,0,0,44,64,30,128,63,192,42,160,85,240,43,240,95,128,17,0,32,128,0,0,0,0
0,0,0,0,0,0,0,0,0,0,11,16,7,160,15,240,13,104,10,188,21,124,10,224,21,64,42,64,20,0,40,0
0,0,0,0,0,0,0,0,0,0,2,200,1,232,3,252,2,170,5,95,2,191,5,248,1,16,0,160,0,0,0,0
; entity 95: page 188 sprite 0 f=10..17
0,0,0,0,0,0,0,0,0,0,111,64,187,128,117,64,26,128,5,0,0,128,0,0,0,0,0,0,0,0,0,0
0,0,0,0,0,160,1,64,2,128,1,80,54,160,93,112,55,224,3,192,0,0,0,0,0,0,0,0,0,0,0,0
0,0,0,0,0,0,0,0,0,0,0,244,25,184,47,84,25,168,0,80,0,8,0,0,0,0,0,0,0,0,0,0
0,0,0,0,0,0,0,0,0,0,0,61,3,126,5,215,3,106,0,20,0,40,0,20,0,10,0,0,0,0,0,0
0,0,0,0,0,0,0,0,0,0,188,0,126,192,235,160,86,192,40,0,20,0,40,0,80,0,0,0,0,0,0,0
0,0,0,0,0,0,0,0,0,0,47,0,29,152,42,244,21,152,10,0,16,0,0,0,0,0,0,0,0,0,0,0
0,0,0,0,5,0,2,128,1,64,10,128,5,108,14,186,7,236,3,192,0,0,0,0,0,0,0,0,0,0,0,0
0,0,0,0,0,0,0,0,0,0,2,246,1,221,2,174,1,88,0,160,1,0,0,0,0,0,0,0,0,0,0,0

@tilemap
                        
                        
                        
                        
                        
WWWWWWWWWWWWWWWWWWWWWWWW
             WW         
             WW         
             WW         
             WW         
             WW         
             WW         
                        
 \  *   *   *           
WW\WWWWWWWWWWWWWWWWWWWWW
WWW\WWWWWWWW+WWWWWWWWWWW

@tilecolors WHT WHT RED GRN WHT WHT
@itemcolor BLK

@guardians
x=6 y=48(40..56) v=0 f=0..1 YEL
y=24 x=13(1..22) v=-1 f=2..9 RED
y=80 x=13(5..12) v=-1 f=10..17 YEL

@tileudg
0: 0,0,0,0,0,0,0,0
1: 255,170,119,170,119,170,85,170 ; invert
2: 32,16,14,193,48,9,198,32
3: 136,169,169,187,191,191,191,94 ; invert
4: 192,192,48,48,12,12,3,3
5: 0,0,0,0,0,0,0,0 ; invert
6: 0,0,0,0,0,0,0,0
