@room 51
@title Tool  Shed
@conn 53 49 0 58
@spawn 44 104
@border CYN
@belt 1

@guardiansprites
; entity 52: page 181 sprite 0 f=0..7
0,0,0,0,0,0,0,0,0,0,0,0,0,0,0,0,0,0,0,0,0,0,0,0,6,0,63,0,31,0,13,0
0,0,0,0,0,0,0,0,0,0,0,0,0,0,1,128,15,192,7,64,3,64,79,64,7,64,3,32,15,32,135,32
0,96,3,240,1,208,0,208,3,208,1,208,0,200,3,200,1,200,0,200,11,200,33,200,0,200,11,196,1,196,32,196
0,0,0,0,0,0,0,0,0,0,0,24,0,252,0,116,0,52,0,244,0,116,1,54,0,250,2,122,0,58,4,250
0,0,0,0,0,0,0,0,0,0,0,0,0,0,0,0,0,0,0,0,0,0,0,0,48,0,126,0,124,0,88,0
0,0,0,0,0,0,0,0,0,0,0,0,0,0,12,0,31,128,23,0,22,0,23,128,23,0,38,16,39,128,39,8
3,0,7,224,5,192,5,128,5,224,5,192,9,128,9,224,9,208,9,128,9,232,9,194,9,128,17,232,17,192,17,130
0,0,0,0,0,0,0,0,0,0,0,192,1,248,1,112,1,96,1,120,1,112,2,96,2,120,2,112,2,97,2,120
; entity 98: page 175 sprite 0 f=8..11
56,0,124,0,126,0,109,128,68,64,108,64,124,32,124,0,124,12,124,50,252,204,255,48,252,192,127,0,108,0,56,0
14,96,31,148,31,8,27,32,17,80,27,80,31,160,31,160,127,64,223,64,223,128,159,128,127,0,31,0,27,0,14,0
3,128,7,192,7,224,6,216,4,68,14,196,127,194,239,192,239,192,143,192,119,192,7,192,7,192,7,192,6,192,3,128
0,224,1,240,1,240,1,178,1,21,1,181,1,250,1,250,7,244,13,244,13,248,9,248,7,240,1,240,1,176,0,224
; entity 99: page 173 sprite 0 f=12..15
12,0,12,0,12,0,12,0,12,0,30,0,18,0,51,0,63,0,115,128,97,128,97,128,192,192,192,192,128,64,128,64
8,64,8,64,12,192,4,128,7,128,7,128,12,192,28,224,59,112,48,48,96,24,96,24,64,8,192,12,128,4,128,4
2,16,2,16,3,48,1,32,1,224,1,224,3,48,7,56,14,220,12,12,24,6,24,6,16,2,48,3,32,1,32,1
0,48,0,48,0,48,0,48,0,48,0,120,0,72,0,204,0,252,1,206,1,134,1,134,3,3,3,3,2,1,2,1

@tilemap
        /WWWWWWW        
       /WWWWWWWW        
      /WWWWWWWWWWWWWWWWW
     /        *         
    /                   
   /                   W
  /                    W
 /                     W
WWWWW     F  F    F    W
WWWWW                  W
WWWWW                 FW
WWWWW  F F     F       W
WWWWW             F    W
WWWWW                 FW
WWWWW+                 W
WWWWW>>>>>>>>>>>>>>>>>>W

@floorcolor CYN
@wallcolor YEL
@nastycolor YEL
@rampcolor WHT
@beltcolor GRN
@itemcolor RED

@guardians
y=104 x=14(5..20) v=-1 f=0..7 PUR
y=72 x=7(5..18) v=1 f=8..11 YEL
y=48 x=18(5..15) v=-1 f=12..15 GRN

@floorudg 90,255,34,68,34,64,0,0
@walludg 85,170,68,34,85,170,68,34
@nastyudg 4,4,4,136,80,32,16,8
@rampudg 3,3,12,12,48,48,192,192
@beltudg 224,170,0,102,102,102,102,102 ; invert
@itemudg 24,24,24,24,24,155,127,59
