@room 12
@title Tree Top
@conn 0 0 8 13
@spawn 44 104
@border YEL
@belt 0

@guardiansprites
; entity 24: page 188 sprite 0 f=0..7
0,0,0,0,0,0,0,0,0,0,111,64,187,128,117,64,26,128,5,0,0,128,0,0,0,0,0,0,0,0,0,0
0,0,0,0,0,160,1,64,2,128,1,80,54,160,93,112,55,224,3,192,0,0,0,0,0,0,0,0,0,0,0,0
0,0,0,0,0,0,0,0,0,0,0,244,25,184,47,84,25,168,0,80,0,8,0,0,0,0,0,0,0,0,0,0
0,0,0,0,0,0,0,0,0,0,0,61,3,126,5,215,3,106,0,20,0,40,0,20,0,10,0,0,0,0,0,0
0,0,0,0,0,0,0,0,0,0,188,0,126,192,235,160,86,192,40,0,20,0,40,0,80,0,0,0,0,0,0,0
0,0,0,0,0,0,0,0,0,0,47,0,29,152,42,244,21,152,10,0,16,0,0,0,0,0,0,0,0,0,0,0
0,0,0,0,5,0,2,128,1,64,10,128,5,108,14,186,7,236,3,192,0,0,0,0,0,0,0,0,0,0,0,0
0,0,0,0,0,0,0,0,0,0,2,246,1,221,2,174,1,88,0,160,1,0,0,0,0,0,0,0,0,0,0,0
; entity 46: page 187 sprite 4 f=8..11
4,0,42,128,85,64,43,128,68,64,175,160,95,64,32,128,85,64,42,128,4,0,4,0,8,0,62,0,65,0,129,0
2,0,21,64,42,160,21,192,34,32,95,80,42,160,16,64,42,160,21,64,2,0,2,0,14,0,17,128,32,64,0,0
0,64,2,168,5,84,3,168,4,68,11,234,5,244,2,8,5,84,2,168,0,64,0,64,0,112,1,136,2,4,0,0
0,32,1,84,2,170,1,212,2,34,5,125,2,250,1,84,2,170,1,84,0,32,0,32,0,16,0,124,0,130,0,129
; entity 26: page 182 sprite 0 f=12..19
0,0,0,0,0,0,0,0,0,0,19,64,23,128,63,192,85,64,250,160,253,64,31,160,8,128,5,0,0,0,0,0
0,0,0,0,0,0,0,0,0,0,8,208,5,224,15,240,22,176,61,80,62,168,7,80,2,168,2,84,0,40,0,20
0,0,0,0,0,0,0,0,0,0,2,52,1,120,3,252,5,84,15,170,15,212,1,250,0,136,1,4,0,0,0,0
0,3,0,10,0,21,0,10,0,21,0,171,0,86,0,235,1,85,3,235,3,255,0,126,0,34,0,34,0,0,0,0
128,0,80,0,168,0,80,0,168,0,213,0,106,0,215,0,170,128,215,192,255,192,126,0,68,0,68,0,0,0,0,0
0,0,0,0,0,0,0,0,0,0,44,64,30,128,63,192,42,160,85,240,43,240,95,128,17,0,32,128,0,0,0,0
0,0,0,0,0,0,0,0,0,0,11,16,7,160,15,240,13,104,10,188,21,124,10,224,21,64,42,64,20,0,40,0
0,0,0,0,0,0,0,0,0,0,2,200,1,232,3,252,2,170,5,95,2,191,5,248,1,16,0,160,0,0,0,0

@tilemap
                        
                        
                        
            +           
                        
                        
            F           
        FF              
          F      F      
   FFF       FF         
                        
                FF      
FFFFFFFFFF    W         
  * ** **WF   W   FF    
* ** *** W \  WFF       
 *   *   W  \FW         

@tilecolors WHT GRN YEL RED WHT WHT
@itemcolor GRN

@guardians
y=40 x=7(0..9) v=-1 f=0..7 CYN
y=80 x=8(0..15) v=-1 f=8..11 YEL
y=24 x=18(5..22) v=-1 f=12..19 RED

@tileudg
0: 0,0,0,0,0,0,0,0
1: 170,85,170,88,48,16,16,8
2: 165,40,82,85,85,73,162,181
3: 137,74,18,52,24,52,82,145 ; invert
4: 64,0,16,0,4,0,1,0
5: 0,0,0,0,0,0,0,0 ; invert
6: 30,45,55,123,109,94,184,192
