@room 9
@title On a Branch Over the Drive
@conn 13 8 4 10
@spawn 44 104
@border RED
@belt 0

@guardiansprites
; entity 9: page 191 sprite 0 f=0..1
128,0,64,0,163,96,83,96,41,192,22,160,11,224,7,112,2,168,5,212,2,42,3,229,3,226,3,97,3,98,7,112
0,0,0,0,6,48,86,48,169,192,86,160,11,224,6,48,3,232,5,212,2,42,3,228,3,234,23,100,14,96,4,112
; entity 27: page 178 sprite 4 f=2..5
3,192,14,240,29,248,62,252,83,206,101,166,164,39,113,143,191,247,85,239,110,118,83,202,56,28,22,120,11,240,2,192
3,192,13,240,26,248,63,252,81,140,100,38,197,167,179,207,93,187,170,119,95,250,114,78,56,28,28,56,11,240,2,192
3,192,11,240,21,120,63,252,80,12,101,166,199,231,241,143,190,127,221,247,44,58,90,94,44,60,22,120,11,240,3,192
3,192,13,240,26,248,63,252,81,140,100,38,197,167,179,207,93,187,170,119,95,250,114,78,56,28,28,56,11,240,2,192
; entity 61: page 173 sprite 0 f=6..9
12,0,12,0,12,0,12,0,12,0,30,0,18,0,51,0,63,0,115,128,97,128,97,128,192,192,192,192,128,64,128,64
8,64,8,64,12,192,4,128,7,128,7,128,12,192,28,224,59,112,48,48,96,24,96,24,64,8,192,12,128,4,128,4
2,16,2,16,3,48,1,32,1,224,1,224,3,48,7,56,14,220,12,12,24,6,24,6,16,2,48,3,32,1,32,1
0,48,0,48,0,48,0,48,0,48,0,120,0,72,0,204,0,252,1,206,1,134,1,134,3,3,3,3,2,1,2,1
; entity 62: page 185 sprite 0 f=10..13
60,0,110,0,167,0,165,0,119,0,163,0,98,0,44,0,52,0,70,0,197,0,238,0,165,0,229,0,118,0,60,0
0,0,0,0,0,176,1,72,3,252,0,68,2,12,2,124,53,216,70,240,197,0,238,0,165,0,229,0,118,0,60,0
0,0,0,0,0,0,0,0,0,0,0,0,0,0,0,0,52,52,70,70,197,197,238,238,165,165,229,229,118,118,60,60
0,0,0,0,15,0,27,128,62,64,48,64,34,0,63,192,18,180,13,70,0,197,0,238,0,165,0,229,0,118,0,60

@tilemap
                        
                        
                        
                        
                        
     **                 
    ***FFF              
     ****    /FFFFFFFFFF
            / *W***W**  
           /  *** *W*   
          /        **   
  +     FF              
 FF                     
      FF                
                        
                        

@tilecolors WHT RED RED GRN WHT WHT
@itemcolor GRN

@guardians
x=22 y=80(64..112) v=2 f=0..1 PUR
x=3 y=72(64..104) v=-2 f=2..5 RED
y=40 x=14(12..22) v=1 f=6..9 YEL
x=10 y=48(0..56) v=1 f=10..13 CYN

@tileudg
0: 0,0,0,0,0,0,0,0
1: 31,243,225,96,48,44,64,128
2: 9,18,10,31,228,8,8,8 ; invert
3: 66,41,84,38,135,35,42,4
4: 5,2,4,8,80,32,64,128
5: 0,0,0,0,0,0,0,0 ; invert
6: 48,60,79,67,130,134,228,252
