@room 50
@title Watch Tower
@conn 0 0 16 0
@spawn 44 104
@border CYN
@belt 1

@guardiansprites
; entity 108: page 187 sprite 4 f=0..3
4,0,42,128,85,64,43,128,68,64,175,160,95,64,32,128,85,64,42,128,4,0,4,0,8,0,62,0,65,0,129,0
2,0,21,64,42,160,21,192,34,32,95,80,42,160,16,64,42,160,21,64,2,0,2,0,14,0,17,128,32,64,0,0
0,64,2,168,5,84,3,168,4,68,11,234,5,244,2,8,5,84,2,168,0,64,0,64,0,112,1,136,2,4,0,0
0,32,1,84,2,170,1,212,2,34,5,125,2,250,1,84,2,170,1,84,0,32,0,32,0,16,0,124,0,130,0,129
; entity 109: page 188 sprite 0 f=4..11
0,0,0,0,0,0,0,0,0,0,111,64,187,128,117,64,26,128,5,0,0,128,0,0,0,0,0,0,0,0,0,0
0,0,0,0,0,160,1,64,2,128,1,80,54,160,93,112,55,224,3,192,0,0,0,0,0,0,0,0,0,0,0,0
0,0,0,0,0,0,0,0,0,0,0,244,25,184,47,84,25,168,0,80,0,8,0,0,0,0,0,0,0,0,0,0
0,0,0,0,0,0,0,0,0,0,0,61,3,126,5,215,3,106,0,20,0,40,0,20,0,10,0,0,0,0,0,0
0,0,0,0,0,0,0,0,0,0,188,0,126,192,235,160,86,192,40,0,20,0,40,0,80,0,0,0,0,0,0,0
0,0,0,0,0,0,0,0,0,0,47,0,29,152,42,244,21,152,10,0,16,0,0,0,0,0,0,0,0,0,0,0
0,0,0,0,5,0,2,128,1,64,10,128,5,108,14,186,7,236,3,192,0,0,0,0,0,0,0,0,0,0,0,0
0,0,0,0,0,0,0,0,0,0,2,246,1,221,2,174,1,88,0,160,1,0,0,0,0,0,0,0,0,0,0,0

@tilemap
                        
                        
                        
                        
       />>>>>>>>        
      /                 
     /                  
    /                   
   /                 +  
  W                  W  
  W   *         *   *W  
  WWWWWWWW   FWWWWWWWW  
        WW    WW        
        WWFF  WW        
        WW    WW        
        WW  FFWW        

@floorcolor YEL
@wallcolor CYN
@nastycolor GRN
@rampcolor WHT
@beltcolor CYN
@itemcolor GRN

@guardians
y=72 x=13(7..14) v=1 f=0..3 PUR
y=56 x=7(5..22) v=-1 f=4..11 YEL

@floorudg 255,255,170,85,170,85,0,0
@walludg 170,85,85,170,85,170,170,85
@nastyudg 70,137,137,54,72,131,132,104
@rampudg 1,2,4,8,16,32,64,128
@beltudg 246,255,231,0,0,0,0,0
@itemudg 116,56,102,191,191,157,66,60
