@room 56
@title West Wing Roof
@conn 0 37 54 57
@spawn 44 104
@border BLU
@belt 0

@guardiansprites
; entity 52: page 181 sprite 0 f=0..7
0,0,0,0,0,0,0,0,0,0,0,0,0,0,0,0,0,0,0,0,0,0,0,0,6,0,63,0,31,0,13,0
0,0,0,0,0,0,0,0,0,0,0,0,0,0,1,128,15,192,7,64,3,64,79,64,7,64,3,32,15,32,135,32
0,96,3,240,1,208,0,208,3,208,1,208,0,200,3,200,1,200,0,200,11,200,33,200,0,200,11,196,1,196,32,196
0,0,0,0,0,0,0,0,0,0,0,24,0,252,0,116,0,52,0,244,0,116,1,54,0,250,2,122,0,58,4,250
0,0,0,0,0,0,0,0,0,0,0,0,0,0,0,0,0,0,0,0,0,0,0,0,48,0,126,0,124,0,88,0
0,0,0,0,0,0,0,0,0,0,0,0,0,0,12,0,31,128,23,0,22,0,23,128,23,0,38,16,39,128,39,8
3,0,7,224,5,192,5,128,5,224,5,192,9,128,9,224,9,208,9,128,9,232,9,194,9,128,17,232,17,192,17,130
0,0,0,0,0,0,0,0,0,0,0,192,1,248,1,112,1,96,1,120,1,112,2,96,2,120,2,112,2,97,2,120
; entity 28: page 188 sprite 0 f=8..15
0,0,0,0,0,0,0,0,0,0,111,64,187,128,117,64,26,128,5,0,0,128,0,0,0,0,0,0,0,0,0,0
0,0,0,0,0,160,1,64,2,128,1,80,54,160,93,112,55,224,3,192,0,0,0,0,0,0,0,0,0,0,0,0
0,0,0,0,0,0,0,0,0,0,0,244,25,184,47,84,25,168,0,80,0,8,0,0,0,0,0,0,0,0,0,0
0,0,0,0,0,0,0,0,0,0,0,61,3,126,5,215,3,106,0,20,0,40,0,20,0,10,0,0,0,0,0,0
0,0,0,0,0,0,0,0,0,0,188,0,126,192,235,160,86,192,40,0,20,0,40,0,80,0,0,0,0,0,0,0
0,0,0,0,0,0,0,0,0,0,47,0,29,152,42,244,21,152,10,0,16,0,0,0,0,0,0,0,0,0,0,0
0,0,0,0,5,0,2,128,1,64,10,128,5,108,14,186,7,236,3,192,0,0,0,0,0,0,0,0,0,0,0,0
0,0,0,0,0,0,0,0,0,0,2,246,1,221,2,174,1,88,0,160,1,0,0,0,0,0,0,0,0,0,0,0

@tilemap
                        
                        
                        
                        
                        
                        
FWW                     
 WW  *   *  * *    *    
 WWFFFFFFFFFFFFFFFFFFFFF
 WW                     
 WW                     
FWW                +    
 WW                    /
 WW                   / 
 WW                  /  
 WWFFFFFFFFFFFFFFFFF/ FF

@floorcolor PUR
@wallcolor CYN
@nastycolor RED
@rampcolor WHT
@beltcolor WHT
@itemcolor CYN

@guardians
y=104 x=13(3..14) v=-1 f=0..7 PUR
y=88 x=13(8..21) v=-1 f=8..15 YEL

@floorudg 255,170,255,164,164,167,228,60
@walludg 225,132,30,72,225,132,30,72
@nastyudg 24,60,126,255,175,85,58,16 ; invert
@rampudg 3,0,12,0,48,0,192,0
@beltudg 0,0,0,0,0,0,0,0 ; invert
@itemudg 0,0,0,10,13,60,242,192
