@room 22
@title To the Kitchens    Main Stairway
@conn 28 21 0 23
@spawn 44 104
@border GRN
@belt -1

@guardiansprites
; entity 90: page 174 sprite 0 f=0..3
126,0,153,0,255,0,129,0,126,0,24,0,36,0,36,0,66,0,66,0,129,0,231,0,165,0,195,0,165,0,231,0
0,0,31,128,38,64,57,192,48,192,31,128,9,0,16,128,32,64,64,32,128,16,224,112,160,80,192,48,160,80,224,112
0,0,0,0,0,0,7,224,9,144,14,112,14,112,6,96,27,216,96,6,128,1,224,7,160,5,192,3,160,5,224,7
0,0,1,248,2,100,3,156,3,12,1,248,0,144,1,8,2,4,4,2,8,1,14,7,10,5,12,3,10,5,14,7
; entity 91: page 190 sprite 0 f=4..7
12,0,18,0,33,0,45,0,33,0,18,0,12,0,12,0,30,0,0,0,55,0,64,0,13,64,172,64,64,128,46,0
14,192,29,160,31,0,31,224,31,0,29,160,14,192,3,0,7,128,0,0,14,192,0,32,43,0,35,80,16,96,7,0
4,8,6,24,7,56,15,252,7,56,6,216,4,200,0,192,1,224,0,0,1,208,4,8,8,212,10,192,0,8,3,176
0,220,1,110,0,62,1,254,0,62,1,110,0,220,0,48,0,120,0,0,0,184,1,2,2,177,0,53,1,0,0,220
; entity 92: page 183 sprite 4 f=8..11
118,0,0,0,110,0,118,0,110,0,0,0,118,0,110,0,0,0,118,0,0,0,0,0,110,0,118,0,0,0,110,0
29,128,42,0,39,96,81,176,75,208,144,128,170,232,148,184,145,128,170,216,145,0,85,0,75,176,43,96,36,0,29,128
3,192,12,48,16,152,50,20,104,130,64,42,181,17,200,69,164,145,154,5,72,66,85,10,40,84,18,136,13,112,3,192
1,184,0,84,6,228,13,138,11,210,1,9,23,85,29,41,1,137,27,85,0,137,0,170,13,210,6,212,0,36,1,184
; entity 93: page 185 sprite 0 f=12..15
60,0,110,0,167,0,165,0,119,0,163,0,98,0,44,0,52,0,70,0,197,0,238,0,165,0,229,0,118,0,60,0
0,0,0,0,0,176,1,72,3,252,0,68,2,12,2,124,53,216,70,240,197,0,238,0,165,0,229,0,118,0,60,0
0,0,0,0,0,0,0,0,0,0,0,0,0,0,0,0,52,52,70,70,197,197,238,238,165,165,229,229,118,118,60,60
0,0,0,0,15,0,27,128,62,64,48,64,34,0,63,192,18,180,13,70,0,197,0,238,0,165,0,229,0,118,0,60
; entity 94: page 175 sprite 4 f=16..23
12,0,22,0,47,0,47,0,79,128,95,128,95,128,159,192,191,192,189,192,186,192,189,64,90,128,93,128,63,0,12,0
0,0,0,0,0,0,0,112,3,152,12,120,51,248,71,240,95,240,191,240,190,160,189,96,90,192,93,64,63,128,14,0
0,0,0,0,0,0,0,0,3,192,28,120,33,252,79,254,95,254,159,255,191,239,95,86,95,174,35,84,31,248,3,192
0,0,0,0,0,0,14,0,23,192,23,240,19,252,11,254,11,254,11,215,5,235,5,215,2,234,2,126,1,140,0,112
7,192,24,48,35,136,68,68,136,34,144,19,144,19,136,34,68,68,35,136,24,48,7,192,3,0,3,0,3,0,3,128
7,192,24,48,32,8,67,132,132,66,136,35,136,35,132,66,67,132,32,8,24,48,7,192,15,128,29,208,8,224,4,64
7,192,31,240,62,120,124,60,126,124,255,254,255,254,240,0,255,128,127,240,127,252,63,248,31,240,7,192,0,0,0,0
7,192,31,240,60,248,120,124,124,252,255,128,252,0,240,0,248,0,126,0,127,128,63,224,31,240,7,192,0,0,0,0
; entity 95: page 188 sprite 0 f=24..31
0,0,0,0,0,0,0,0,0,0,111,64,187,128,117,64,26,128,5,0,0,128,0,0,0,0,0,0,0,0,0,0
0,0,0,0,0,160,1,64,2,128,1,80,54,160,93,112,55,224,3,192,0,0,0,0,0,0,0,0,0,0,0,0
0,0,0,0,0,0,0,0,0,0,0,244,25,184,47,84,25,168,0,80,0,8,0,0,0,0,0,0,0,0,0,0
0,0,0,0,0,0,0,0,0,0,0,61,3,126,5,215,3,106,0,20,0,40,0,20,0,10,0,0,0,0,0,0
0,0,0,0,0,0,0,0,0,0,188,0,126,192,235,160,86,192,40,0,20,0,40,0,80,0,0,0,0,0,0,0
0,0,0,0,0,0,0,0,0,0,47,0,29,152,42,244,21,152,10,0,16,0,0,0,0,0,0,0,0,0,0,0
0,0,0,0,5,0,2,128,1,64,10,128,5,108,14,186,7,236,3,192,0,0,0,0,0,0,0,0,0,0,0,0
0,0,0,0,0,0,0,0,0,0,2,246,1,221,2,174,1,88,0,160,1,0,0,0,0,0,0,0,0,0,0,0

@tilemap
    W                   
    W                   
    W                   
                   *    
                        
   FWFFFFFFFFFFF    FFFF
    W+                  
    W                   
WWFFW FF  <<            
WW  W           FFFFF   
WW  W        FF         
                       \
                        
                        
WWWWWWWWWWWWWWWWWWWWWWWW
WWWWWWWWWWWWWWWWWWWWWWWW

@tilecolors WHT CYN RED CYN WHT PUR
@itemcolor RED

@guardians
y=24 x=2(0..7) v=1 f=0..3 PUR
y=24 x=12(9..15) v=-1 f=4..7 YEL
y=48 x=16(8..16) v=-1 f=8..11 WHT
y=72 x=2(2..2) v=1 f=12..15 RED
y=96 x=16(0..22) v=-1 f=16..23 GRN
y=80 x=7(5..12) v=-1 f=24..31 YEL

@tileudg
0: 0,0,0,0,0,0,0,0
1: 255,255,0,255,0,0,0,0
2: 0,21,191,21,0,81,251,81
3: 24,90,189,25,126,153,36,36 ; invert
4: 192,128,48,32,12,8,3,2
5: 240,170,120,255,170,85,170,85 ; invert
6: 64,160,240,248,252,122,37,2
